107
11
0 0 0 0 0 0 0 0 0 0 0 0 0 0 0 0 0 0 0 0 0 0 0 0 0 0 0 0 0 0 0 0 0 0 0 0 0 0 0 0 0 0 0 0 0 0 0 0 0 0 0 0 0 0 0 0 0 0 0 0 0 0 0 0 0 0 0 0 0 0 0 0 0 0 0 0 0 0 0 0 0 0 0 0 0 0 0 0 0 0 0 0 0 0 0 0 0 0 0 0 0 0 0 0 0 0 0 
0 0 0 0 0 0 0 0 0 0 0 0 0 0 0 0 0 0 0 0 0 0 0 0 0 0 0 0 0 0 0 0 0 0 0 0 0 0 0 0 0 0 0 0 0 0 0 0 0 0 0 0 0 0 0 0 0 0 0 0 0 0 0 0 0 0 0 0 0 0 0 0 0 0 0 0 0 0 0 0 0 0 0 0 0 0 0 0 0 0 0 0 0 0 0 0 0 0 0 0 0 0 0 0 0 0 22 
22 4 0 0 0 0 0 0 0 0 0 0 0 0 0 0 0 0 0 0 0 0 0 0 0 0 0 0 0 0 0 0 0 0 0 0 0 0 0 0 0 0 0 0 0 0 0 0 0 0 0 0 0 0 0 0 0 0 0 0 0 0 0 0 0 0 0 0 0 0 0 0 0 0 0 0 0 0 0 0 0 0 0 18 19 19 19 19 19 19 19 19 19 19 19 19 19 19 19 19 19 19 19 19 20 0 22 
22 4 0 0 0 0 0 0 0 0 0 0 0 0 0 0 0 0 0 0 0 0 0 0 0 0 0 0 0 0 0 0 0 0 0 0 0 0 0 0 0 0 0 0 0 0 0 0 0 0 0 0 0 0 0 0 0 0 0 0 0 0 0 0 0 0 0 0 0 0 0 0 0 0 0 0 0 0 0 0 0 0 0 10 10 10 10 10 10 10 10 10 10 10 10 10 10 10 10 10 10 10 10 10 10 10 22 
22 0 0 0 0 0 0 0 0 0 0 0 0 0 0 0 0 0 0 0 0 0 0 0 0 0 0 0 0 0 0 0 0 0 0 0 0 0 0 0 0 0 0 0 0 0 0 0 0 0 0 0 0 0 0 0 0 0 0 0 0 0 0 0 0 0 0 0 0 0 0 0 0 18 19 19 19 19 19 19 19 20 0 14 13 14 13 14 13 14 13 14 13 14 13 14 13 14 13 14 13 14 13 14 13 14 22 
22 18 19 19 19 19 19 19 19 19 19 19 19 19 20 0 0 0 23 25 0 18 19 19 19 19 19 19 19 19 19 19 19 19 19 19 20 0 0 0 0 0 0 0 0 18 19 19 19 19 19 19 19 19 19 19 19 19 19 19 20 0 0 0 0 0 0 0 0 0 0 0 10 10 10 10 10 10 10 10 10 10 10 13 14 21 11 12 11 12 11 21 21 21 21 21 21 21 21 21 21 21 21 21 21 12 22 
22 9 10 10 10 10 9 10 10 10 10 9 10 5 21 21 2 0 0 0 10 10 9 10 10 10 10 9 10 10 10 10 9 10 10 10 10 10 0 0 0 0 0 0 10 10 10 10 10 9 10 10 10 10 9 10 10 10 10 9 10 10 0 0 0 0 0 0 0 0 0 0 13 14 13 14 13 14 13 21 21 21 13 14 12 22 13 14 13 21 13 14 13 14 13 14 13 14 13 14 13 14 13 14 26 21 22 
22 11 12 11 12 11 16 11 12 11 11 13 21 21 27 22 4 0 0 0 11 12 11 12 11 12 11 16 11 12 11 12 11 12 11 12 11 12 0 0 23 25 0 1 21 21 21 21 11 16 11 12 11 12 16 12 11 12 11 16 11 12 0 0 0 0 23 24 24 25 0 0 11 12 11 16 11 16 11 12 14 13 14 13 14 22 11 12 11 12 11 12 11 12 11 12 11 12 11 12 11 12 11 12 11 12 22 
22 13 14 13 14 15 17 13 14 13 14 21 22 22 22 22 4 0 0 1 21 11 12 11 12 14 15 17 13 14 13 14 13 14 13 14 13 21 2 0 0 0 0 3 22 22 22 22 13 17 15 14 13 14 17 15 13 14 13 17 15 11 0 0 0 0 0 0 0 0 0 0 12 14 12 17 15 17 15 14 12 11 12 11 21 21 21 21 21 14 13 14 13 14 13 14 13 14 13 14 13 14 13 14 13 14 22 
26 21 21 21 21 21 21 21 21 21 21 27 22 22 22 22 4 0 0 3 26 21 21 21 21 21 21 21 21 21 21 21 21 21 21 21 21 22 4 0 0 0 0 3 22 22 22 26 21 21 21 21 21 21 21 21 21 21 21 21 21 21 21 21 21 2 0 0 0 0 0 1 21 21 21 21 21 21 21 21 21 21 21 21 27 22 22 22 26 21 21 21 21 21 21 21 21 21 21 21 21 21 21 21 21 21 27 
22 22 22 22 22 22 22 22 22 22 22 22 22 22 22 22 4 0 0 3 22 22 22 22 22 22 22 22 22 22 22 22 22 22 22 22 22 22 4 0 0 0 0 3 22 22 22 22 22 22 22 22 22 22 22 22 22 22 22 22 22 22 22 22 22 4 0 0 0 0 0 3 22 22 22 22 22 22 22 22 22 22 22 22 22 22 22 22 22 22 22 22 22 22 22 22 22 22 22 22 22 22 22 22 22 22 22 
