63
20
22 22 22 22 22 22 22 22 22 22 22 22 22 22 22 22 22 22 22 22 22 22 22 22 22 22 22 22 22 22 22 22 22 22 22 22 22 22 22 22 22 22 22 22 22 22 22 22 22 22 22 22 22 22 22 22 22 22 22 22 22 22 22 
22 10 10 9 10 10 9 10 10 9 10 10 9 10 10 9 10 10 9 10 10 9 10 10 9 10 10 9 10 10 9 10 10 9 10 10 9 10 10 9 10 10 9 10 10 9 10 10 9 10 10 9 10 10 9 10 10 9 10 10 9 10 22 
22 14 13 14 13 14 13 14 13 14 13 14 13 14 13 14 13 14 13 14 13 14 13 14 13 14 13 14 13 14 13 14 13 14 13 14 13 14 13 14 13 14 13 14 13 14 13 14 13 14 13 14 13 14 13 14 13 14 13 14 13 14 22 
22 13 14 13 21 21 21 21 21 21 21 21 21 21 21 21 21 21 21 21 21 21 21 21 21 21 21 21 21 21 21 21 21 21 21 21 21 21 21 21 21 21 21 21 21 21 21 21 21 21 21 21 21 21 21 21 21 21 21 21 21 12 22 
22 21 13 14 11 12 11 14 13 14 0 0 0 0 0 0 0 0 0 0 0 0 0 0 0 0 0 0 0 0 0 0 0 0 0 0 0 0 13 14 13 14 13 14 13 14 13 14 13 14 13 14 13 14 13 14 13 14 12 14 12 14 22 
22 13 14 13 14 13 14 13 14 13 0 0 0 0 0 0 0 0 0 0 0 0 0 0 0 0 0 0 0 0 0 0 0 0 0 0 0 0 14 13 14 13 14 13 14 13 14 13 14 13 14 13 14 13 14 13 14 13 14 12 14 12 22 
22 14 13 21 13 14 13 14 13 14 0 0 0 0 0 0 0 0 0 0 0 0 0 0 0 0 0 0 0 0 0 0 0 0 0 0 0 0 21 21 21 21 21 21 21 21 21 21 21 21 21 21 21 21 21 21 21 21 21 21 21 14 22 
22 13 14 13 14 13 14 13 14 13 0 0 0 0 0 0 0 0 0 0 0 0 0 0 0 0 0 0 0 0 0 0 0 0 0 0 0 0 22 22 22 22 22 22 22 22 22 22 22 22 22 22 22 22 22 22 22 22 22 22 22 13 22 
22 21 13 14 13 14 13 14 13 14 0 0 0 0 0 0 0 0 0 0 0 0 0 0 0 0 0 0 0 0 0 0 0 0 0 0 0 0 22 22 13 14 13 14 13 14 13 14 13 14 13 14 13 14 13 14 13 14 13 14 13 14 22 
22 13 14 13 14 13 14 13 14 13 0 0 28 0 0 0 0 0 0 0 0 0 0 0 0 0 0 0 0 0 0 0 0 0 0 0 0 0 22 22 14 0 0 0 0 0 0 0 0 0 0 0 0 0 0 0 0 0 0 0 0 13 22 
22 21 21 21 21 21 21 21 21 21 0 0 0 0 28 0 0 0 0 0 0 0 0 0 0 0 0 0 0 0 0 0 0 0 0 0 0 0 22 22 13 0 0 0 0 0 0 0 0 0 0 0 0 0 0 0 0 0 0 0 0 14 22 
22 9 10 9 10 9 10 9 10 9 0 0 0 0 0 0 0 0 28 0 0 0 23 24 24 25 0 0 0 0 0 0 0 0 0 0 0 0 22 22 14 0 0 0 0 0 0 0 0 0 0 0 0 0 0 0 0 0 0 0 0 13 22 
22 14 13 14 13 14 13 14 13 14 0 0 0 0 0 0 0 10 10 9 10 10 10 9 10 10 10 9 21 21 21 0 0 0 0 28 0 0 22 22 13 0 0 0 0 0 0 0 0 0 0 0 0 0 0 0 0 0 0 0 0 14 22 
22 13 14 13 14 14 14 13 14 13 0 0 0 0 0 0 0 11 16 11 13 11 13 11 13 11 13 11 13 14 13 0 0 0 0 0 0 0 22 22 14 0 0 0 0 0 0 0 0 0 0 0 0 0 0 0 0 0 0 0 0 13 22 
22 14 13 14 13 14 13 14 13 14 0 0 0 0 0 0 0 21 17 16 11 13 11 13 11 13 11 13 11 13 16 0 21 0 0 0 0 0 22 22 13 0 0 0 0 0 0 0 0 0 0 0 0 0 0 0 0 0 0 0 0 14 22 
22 13 14 13 14 13 14 13 14 13 0 0 0 0 0 0 0 22 21 17 16 11 13 11 13 11 13 11 13 14 17 0 0 0 0 0 0 0 22 22 14 13 14 13 14 13 14 13 14 13 14 13 14 13 14 13 14 13 14 13 14 13 22 
22 16 16 16 16 16 16 16 16 14 0 23 24 24 24 25 0 22 22 21 17 16 11 13 11 13 11 13 11 13 21 0 0 0 0 0 0 0 22 22 13 14 13 14 13 14 13 14 13 14 13 14 13 14 13 14 13 14 21 21 21 21 22 
22 17 17 17 17 17 17 17 17 15 0 0 0 0 0 0 0 22 22 22 21 17 15 14 13 14 13 14 13 14 15 0 0 0 0 0 0 0 22 22 21 21 21 21 21 21 21 21 21 21 21 21 21 21 21 21 21 21 27 22 22 22 22 
22 21 21 21 21 21 21 21 21 21 0 0 0 0 0 0 0 22 22 22 22 21 21 21 21 21 21 21 21 21 21 0 0 0 0 0 0 0 22 22 22 22 22 22 22 22 22 22 22 22 22 22 22 22 22 22 22 22 22 22 22 22 22 
22 22 22 22 22 22 22 22 22 22 0 0 0 0 0 0 0 22 22 22 22 22 22 22 22 22 22 22 22 22 22 0 0 0 0 0 0 0 22 22 22 22 22 22 22 22 22 22 22 22 22 22 22 22 22 22 22 22 22 22 22 22 22 
