45
72
0 0 0 0 0 0 0 0 0 0 0 0 0 0 0 0 0 0 0 0 0 0 0 0 0 0 0 0 0 0 0 0 0 0 0 0 0 0 0 0 0 0 0 0 0 
23 23 0 0 0 0 0 0 0 0 0 0 0 0 0 0 0 0 0 0 0 0 0 0 0 0 0 0 0 0 0 0 0 0 0 0 0 0 0 23 23 23 23 23 23 
23 23 18 19 19 19 19 19 19 19 19 19 19 19 19 19 19 19 19 19 19 19 19 19 19 19 19 19 19 19 19 19 19 19 19 19 19 19 20 23 23 23 23 23 23 
23 23 10 9 10 10 10 9 10 10 10 9 10 10 10 9 10 10 10 9 10 10 10 9 10 10 10 9 10 10 10 9 10 10 10 9 10 10 10 23 23 23 23 23 23 
23 23 21 21 21 21 21 21 21 21 21 21 21 21 21 21 21 21 21 21 21 21 21 21 21 21 21 21 21 21 21 21 21 21 21 21 21 21 21 23 23 23 23 23 23 
23 23 21 21 21 21 21 21 21 21 21 21 21 21 21 21 21 21 21 21 21 21 21 21 21 21 21 21 21 21 21 21 21 21 21 21 21 21 21 23 23 23 23 23 23 
23 23 21 21 21 21 21 21 21 21 21 31 32 32 33 21 21 21 21 21 21 21 21 21 21 21 21 21 21 21 21 21 21 21 21 21 21 21 21 23 23 23 23 23 23 
23 23 16 16 16 21 21 21 21 21 21 21 21 21 21 21 34 21 21 16 16 16 16 16 16 16 16 16 16 16 16 16 21 21 21 21 21 21 21 23 23 23 23 23 23 
23 23 17 17 17 15 22 22 22 22 21 21 21 21 21 21 21 21 21 17 17 17 17 17 17 17 17 17 17 17 17 17 15 21 21 21 21 21 21 23 23 23 23 23 23 
23 23 22 22 22 22 23 23 23 23 21 21 21 21 21 21 21 21 22 22 22 22 22 22 22 22 22 22 22 22 22 22 22 22 22 22 22 22 22 23 23 23 23 23 23 
23 23 23 23 23 23 23 23 23 23 21 21 21 21 21 21 21 21 23 23 23 23 23 23 23 23 23 23 23 23 23 23 23 23 23 23 23 23 23 23 23 23 23 23 23 
23 23 23 23 23 23 23 23 23 23 21 21 21 21 21 34 21 21 10 9 10 9 10 23 23 23 10 10 9 10 10 9 10 10 9 10 10 9 10 10 9 10 10 9 23 
23 23 23 23 23 23 23 23 23 23 21 21 34 21 21 21 21 21 21 21 21 21 21 23 23 23 21 21 21 21 21 21 21 21 21 21 21 21 21 21 21 21 21 21 23 
23 23 23 23 10 9 10 9 10 10 34 21 21 21 21 21 34 21 21 21 21 21 21 23 23 23 21 21 21 21 21 21 21 21 21 21 21 21 21 21 21 21 21 21 23 
23 23 23 23 21 21 21 21 21 21 21 21 21 21 34 21 21 21 21 21 31 32 33 23 23 23 34 21 21 21 21 21 21 21 21 31 32 32 32 32 33 21 21 21 23 
23 23 23 23 21 21 21 21 21 21 21 34 21 21 21 21 21 21 21 21 21 21 21 23 23 23 21 21 21 21 21 21 34 21 21 21 21 21 21 21 21 21 21 34 23 
23 23 23 23 21 21 21 21 21 21 21 21 21 34 21 21 21 34 21 21 21 21 21 23 23 23 21 21 21 34 21 21 21 21 21 21 21 21 21 21 21 21 21 21 23 
23 23 23 23 21 21 21 21 21 21 21 21 21 21 21 21 21 21 21 21 21 21 21 23 23 23 34 21 21 21 21 21 21 21 21 21 21 21 21 21 21 21 21 21 23 
23 23 23 23 22 22 22 22 22 22 22 22 22 22 22 22 22 22 22 22 22 21 21 21 21 21 21 21 21 21 21 21 21 21 21 21 21 21 21 21 21 31 32 33 23 
23 23 23 23 23 23 23 23 23 23 23 23 23 23 23 23 23 23 23 23 23 22 21 21 21 21 21 21 21 21 21 21 21 21 21 21 21 21 21 21 21 21 21 21 23 
23 23 23 23 23 23 23 23 23 23 23 23 23 23 23 23 23 23 23 23 23 23 22 21 21 21 21 21 21 21 21 21 21 21 21 21 21 21 21 34 21 21 21 21 23 
23 23 23 23 23 23 23 23 23 23 23 23 23 23 23 23 23 23 23 23 23 23 23 21 21 21 21 21 21 21 21 21 21 21 21 34 21 21 21 21 21 21 21 21 23 
23 23 23 23 23 23 23 23 23 23 23 23 23 23 23 23 23 23 23 23 23 23 23 21 21 31 32 32 32 32 32 32 33 21 21 21 21 21 21 21 21 34 21 21 23 
23 23 23 23 23 23 23 23 23 23 23 23 23 23 23 23 23 23 23 23 23 23 23 21 21 21 21 21 21 21 21 21 21 21 21 21 21 21 21 21 21 21 21 21 23 
23 23 23 23 10 9 10 10 10 9 10 10 10 9 10 10 9 10 10 10 9 10 10 21 21 21 21 21 21 21 21 21 21 21 34 21 21 21 21 21 21 21 21 21 23 
23 23 23 23 21 21 21 21 21 21 21 21 21 21 21 21 21 21 21 21 21 21 21 21 21 21 21 21 21 21 21 21 21 21 21 21 21 21 21 21 21 21 21 21 23 
23 23 23 23 21 21 21 21 21 21 21 21 21 21 21 21 21 21 21 21 21 21 21 21 21 21 21 21 21 21 21 21 21 21 21 21 31 32 32 32 33 21 21 21 23 
23 23 23 23 21 21 21 21 21 21 21 21 21 21 21 21 21 21 21 21 21 21 21 21 21 21 21 21 21 21 21 21 21 21 21 21 21 21 21 21 21 21 21 21 23 
23 23 23 23 21 21 31 32 32 32 32 32 32 33 21 21 21 21 21 21 21 21 21 21 21 21 21 21 21 21 21 21 21 21 21 21 21 21 21 21 21 21 21 34 23 
23 23 23 23 21 21 21 21 21 21 21 21 21 21 21 21 21 21 21 21 21 21 21 16 16 16 16 21 31 33 21 21 21 21 21 21 34 21 21 21 21 21 34 21 23 
23 23 23 23 21 21 21 21 21 21 21 21 21 21 21 21 31 32 32 33 21 21 15 17 17 17 17 21 21 21 21 21 21 21 21 21 21 21 21 21 21 21 21 21 23 
23 23 23 23 21 21 21 21 21 21 21 21 21 21 21 21 21 21 21 21 21 21 22 22 22 22 22 21 21 21 21 22 22 22 22 21 21 21 22 22 22 22 22 22 23 
23 23 23 23 21 21 21 21 21 21 21 21 21 21 21 21 21 21 21 21 21 21 23 23 23 23 23 21 21 21 21 23 23 23 23 21 21 21 23 23 23 23 23 23 23 
23 23 23 23 31 32 32 33 21 21 21 21 21 21 21 21 21 21 21 21 21 21 23 23 23 23 23 21 21 21 21 23 23 23 23 21 21 21 23 23 23 23 23 23 23 
23 23 23 23 21 21 21 21 21 21 21 21 21 21 21 21 21 21 21 21 21 21 23 23 23 23 23 21 21 21 21 23 23 23 23 21 21 21 23 23 23 23 23 23 23 
23 23 23 23 21 21 21 21 21 21 21 21 21 21 31 33 21 21 21 21 21 21 23 23 23 23 23 21 21 21 21 23 23 23 23 21 21 21 23 23 23 23 23 23 23 
23 23 23 23 21 21 21 21 21 21 21 21 21 21 21 21 21 21 21 21 21 21 23 23 23 23 23 21 21 21 21 23 23 23 23 21 21 21 23 23 23 23 23 23 23 
23 23 23 23 21 21 21 21 21 21 21 21 21 21 21 21 21 21 21 21 21 21 23 23 23 23 23 21 21 21 21 23 23 23 23 21 21 21 23 23 23 23 23 23 23 
23 23 23 23 21 21 21 21 31 32 32 32 32 32 33 21 21 21 21 21 21 21 23 23 23 23 23 21 21 21 21 23 23 23 23 21 21 21 23 23 23 23 23 23 23 
23 23 23 23 21 21 21 21 21 21 21 21 21 21 21 21 21 21 21 21 21 21 23 23 23 23 23 21 21 21 21 23 23 23 23 21 21 21 23 23 23 23 23 23 23 
23 23 23 23 21 21 21 21 21 21 21 21 21 21 21 21 21 21 21 21 21 21 23 23 23 23 23 21 21 21 21 23 23 23 23 21 21 21 23 23 23 23 23 23 23 
23 23 23 23 21 21 21 21 21 21 21 21 31 32 32 32 32 32 32 32 32 33 23 23 23 23 23 21 21 21 21 23 23 23 23 21 21 21 23 23 23 23 23 23 23 
23 23 23 23 21 21 21 21 21 21 21 21 21 21 21 21 21 21 21 21 21 21 23 23 23 23 23 21 21 21 21 23 23 23 23 21 21 21 23 23 23 23 23 23 23 
23 23 23 23 21 21 21 21 21 21 21 21 21 21 21 21 21 21 21 21 21 21 23 23 23 23 23 21 21 21 21 23 23 23 23 21 21 21 23 23 23 23 23 23 23 
23 23 23 23 21 21 21 21 21 21 21 21 21 21 21 21 21 21 21 21 21 21 23 23 23 23 23 21 21 21 21 23 23 23 23 21 21 21 23 23 23 23 23 23 23 
23 23 23 23 21 21 21 21 21 21 21 21 21 21 21 21 21 21 21 21 21 21 23 23 23 23 23 21 21 21 21 23 23 23 23 21 21 21 23 23 23 23 23 23 23 
23 23 23 23 21 21 21 21 21 21 21 21 21 21 21 21 21 21 21 21 21 21 23 23 23 23 23 21 21 21 21 23 23 23 23 21 21 21 23 23 23 23 23 23 23 
23 23 23 23 31 32 32 32 32 32 32 32 33 21 21 21 21 21 21 21 21 21 23 23 23 23 23 21 21 21 21 9 10 10 9 21 21 21 10 9 10 9 10 23 23 
23 23 23 23 21 21 21 21 21 21 21 21 21 21 21 21 21 21 21 21 21 21 23 23 23 23 23 21 21 21 21 21 21 21 21 21 21 21 21 21 21 21 21 23 23 
23 23 23 23 21 21 21 21 21 21 21 21 21 21 21 21 21 21 21 21 21 21 23 23 23 23 23 21 21 21 21 21 21 21 21 21 21 16 16 16 16 16 16 23 23 
23 23 23 23 21 21 21 21 21 21 21 21 21 21 21 21 21 21 21 21 21 21 23 23 23 23 23 21 21 21 21 21 21 21 21 21 15 17 17 17 17 17 17 23 23 
23 23 23 23 21 21 21 21 21 21 21 21 21 21 21 21 21 21 21 21 21 21 23 23 23 23 23 21 21 21 21 21 21 21 21 21 22 22 22 22 22 22 22 23 23 
23 23 23 23 21 21 21 21 21 21 21 21 31 32 32 32 32 32 32 32 32 33 23 23 23 23 23 21 21 21 21 21 21 21 21 21 23 23 23 23 23 23 23 23 23 
23 23 23 23 21 21 21 21 21 21 21 21 21 21 21 21 21 21 21 21 21 21 23 23 23 23 23 21 21 21 21 21 21 21 21 21 23 23 23 23 23 23 23 23 23 
23 23 23 23 21 21 21 21 21 21 21 21 21 21 21 21 21 21 21 21 21 21 10 9 10 9 10 21 21 21 21 21 21 21 21 21 10 9 10 10 9 10 10 23 23 
23 23 23 23 31 32 32 32 32 32 32 33 21 21 21 21 21 21 21 21 21 21 21 21 21 21 21 21 21 21 21 21 21 21 21 21 21 21 21 21 21 21 21 23 23 
23 23 23 23 21 21 21 21 21 21 21 21 21 21 21 21 21 21 21 21 21 21 21 21 21 21 21 21 21 21 21 21 21 21 21 21 21 16 16 16 16 16 16 23 23 
23 23 23 23 21 21 21 21 21 21 21 21 21 21 21 21 21 21 21 21 21 21 21 21 21 21 21 21 21 21 21 21 21 21 21 21 15 17 17 17 17 17 17 23 23 
23 23 23 23 21 21 21 21 21 21 21 21 21 21 21 21 21 21 21 21 21 21 21 21 21 21 21 21 21 21 21 21 21 21 21 21 23 23 23 23 23 23 23 23 23 
23 23 23 23 21 21 21 21 21 21 21 21 21 21 21 21 21 21 21 21 21 21 21 21 21 21 21 21 21 21 21 21 21 21 21 21 23 23 23 23 23 23 23 23 23 
23 23 23 23 21 21 21 21 21 21 21 21 21 21 21 21 21 21 21 21 21 21 21 21 21 21 21 21 21 21 21 21 21 21 21 21 23 23 23 23 23 23 23 23 23 
23 23 23 23 21 21 21 21 21 21 16 16 16 16 16 16 16 16 21 21 21 16 16 16 16 16 16 16 16 16 16 16 16 16 16 16 23 23 23 23 23 23 23 23 23 
23 23 23 23 21 21 21 21 21 21 17 17 17 17 17 17 17 17 15 21 15 17 17 17 17 17 17 17 17 17 17 17 17 17 17 17 23 23 23 23 23 23 23 23 23 
23 23 23 23 21 21 21 21 21 21 22 22 22 22 22 23 22 22 22 22 22 22 23 23 23 23 23 23 23 23 23 23 23 23 23 23 23 23 23 23 23 23 23 23 23 
23 23 23 23 21 21 21 21 21 22 23 23 23 23 23 23 23 23 23 23 23 23 23 23 23 23 23 23 23 23 23 23 23 23 23 23 23 23 23 23 23 23 23 23 23 
23 23 23 23 21 21 21 21 22 23 23 23 23 23 23 23 23 23 23 23 23 23 23 23 23 23 23 23 23 23 23 23 23 23 23 23 23 23 23 23 23 23 23 23 23 
23 23 23 23 21 21 21 22 23 23 23 23 23 23 23 23 23 23 23 23 23 23 23 23 23 23 23 23 23 23 23 23 23 23 23 23 23 23 23 23 23 23 23 23 23 
23 23 23 23 21 21 22 23 23 23 23 23 23 23 23 23 23 23 23 23 23 23 23 23 23 23 23 23 23 23 23 23 23 23 23 23 23 23 23 23 23 23 23 23 23 
23 23 23 23 21 22 23 23 23 23 23 23 23 23 23 23 23 23 23 23 23 23 23 23 23 23 23 23 23 23 23 23 23 23 23 23 23 23 23 23 23 23 23 23 23 
23 23 23 23 22 22 23 23 23 23 23 23 23 23 23 23 23 23 23 23 23 23 23 23 23 23 23 23 23 23 23 23 23 23 23 23 23 23 23 23 23 23 23 23 23 
23 23 23 23 23 23 23 23 23 23 23 23 23 23 23 23 23 23 23 23 23 23 23 23 23 23 23 23 23 23 23 23 23 23 23 23 23 23 23 23 23 23 23 23 23 
23 23 23 23 23 23 23 23 23 23 23 23 23 23 23 23 23 23 23 23 23 23 23 23 23 23 23 23 23 23 23 23 23 23 23 23 23 23 23 23 23 23 23 23 23 
